wwwwwwwwwwwwwwwwwwwwwwwwwwwwww
w----------------------------w
w----------------------------w
w----------------------------w
w----------------------------w
w----------------------------w
w------------t---------------w
w----------------------------w
w----------------------------w
w----------------------------w
w-----------c----------------w
w----------------------------w
w------wwwwwwwwwwwwwwww------w
w------w-----w---------------w
w------w-----w---------------w
w------------w---------------w
w------t--------------t------w
w----------------------------w
w------------w-------w-------w
w------------w-------w-------w
w------------w--------w------w
w------wwwwwwwwwwwwwww-------w
w-----------------w----------w
w-----------------w----------w
w-----------------w----------w
w-----------------w----------w
w-------------t---w----------w
w----------------------------w
w----------------------------w
wwwwwwwwwwwwwwwwwwwwwwwwwwwwww
