wwwwwwwwwwwwwwwwwwwwwwwwwwwwww
w----------------------------w
w----------------------------w
w----------------------------w
w----------------------------w
w----------------------------w
w----------------------------w
w----------------------------w
w----------------------------w
w----------------------------w
w----------------------------w
w----------------------------w
w------wwwwwww---------------w
w------------w---------------w
w------------w---------------w
w------------w---------------w
w------------w---------------w
w------------w---------------w
w------------w---------------w
w------------w---------------w
w------------w---------------w
w------wwwwwwwwwwwwwww-------w
w----------------------------w
w------t--------t------------w
w---------------------t------w
w-------------t--------------w
w-----t----------------------w
w----------------------t-----w
w--------------t-------------w
wwwwwwwwwwwwwwwwwwwwwwwwwwwwww
