wwwwwwwwwwwwwwwwwwwwwwwwwwwwww
w----------------------------w
w----------------------------w
w----------------------------w
w----------------------------w
w----------------------------w
w------------t---------------w
w----------------------------w
w----------------------------w
w----------------------------w
w----------------------------w
w----------------------------w
w------wwwwwww---------------w
w------------w---------------w
w------------w---------------w
w------------w---------------w
w------t-----w--------t------w
w------------w---------------w
w------------w---------------w
w------------w---------------w
w------------w---------------w
w------wwwwwwwwwwwwwww-------w
w----------------------------w
w----------------------------w
w----------------------------w
w----------------------------w
w-------------t--------------w
w----------------------------w
w----------------------------w
wwwwwwwwwwwwwwwwwwwwwwwwwwwwww
