wwwwwwwwwwwwwwwwwwwwwwwwwwwwww
w----------------------------w
w----tt----------------tt----w
w----tt----------------tt----w
w----------------------------w
w------------tt--------------w
w------------tt--------------w
w----------------------------w
w----------------------------w
w-----------cc---------tt----w
w-----------cc---------tt----w
w----------------------------w
w------wwwwwwwwwwwwwwww------w
w------w-----w---------------w
w------w-----w---------------w
w------------w--------tt-----w
w------tt-------------tt-----w
w------tt--------------------w
w------------w-------w-------w
w------------w-------w-------w
w------------w-------ww------w
w------wwwwwwwwwwwwwww-------w
w-----------------w----------w
w-----------------w----------w
w--tt-------------w----------w
w--tt--------tt---w----------w
w------------tt---w-----tt---w
w-----------------------tt---w
w----------------------------w
wwwwwwwwwwwwwwwwwwwwwwwwwwwwww
