wwwwwwwwww
w--------w
w--------w
w----w---w
w----w---w
w----w---w
w---ww---w
w--------w
w--------w
wwwwwwwwww
